MOMR1A	Angular Momentum
MOMR1B	Angular Momentum
MOMR2A	Angular Momentum
MOMR2B	Angular Momentum
MOMR3A	Angular Momentum
MOMR4A	Angular Momentum
EQCAP1A	Capacitance
EQCAP1B	Capacitance
EQCAP1C	Capacitance
EQCAP1D	Capacitance
EQCAP2A	Capacitance
EQCAP2B	Capacitance
EQCAP3A	Capacitance
EQCAP3B	Capacitance
EQCAP4A	Capacitance
EQCAP4B	Capacitance
EQCAP5A	Capacitance
EQCAP6A	Capacitance
CAP1A	Capacitance
CAP1B	Capacitance
CAP2A	Capacitance
CAP2B	Capacitance
CAP3A	Capacitance
CAP4A	Capacitance
CAP5A	Capacitance
CAP6A	Capacitance
CAP6B	Capacitance
CAP9A	Capacitance
CAP9B	Capacitance
ROTS1A	Circular Motion
ROTS1B	Circular Motion
ROTS1C	Circular Motion
ROTS2A	Circular Motion
ROTS3A	Circular Motion
ROTS4A	Circular Motion
ROTS5A	Circular Motion
ROTS6A	Circular Motion
ROTS6B	Circular Motion
ROTS6C	Circular Motion
ROTS7A	Circular Motion
ROTS8A	Circular Motion
ROTS8B	Circular Motion
KIR1A	DC Circuits
KIR1B	DC Circuits
KIR2A	DC Circuits
KIR3A	DC Circuits
KIR3B	DC Circuits
KIR3C	DC Circuits
KIR4A	DC Circuits
KIR5A	DC Circuits
KIR7A	DC Circuits
EPOW1	DC Circuits
EPOW2	DC Circuits
EPOW3	DC Circuits
EPOW4	DC Circuits
RC1A	DC Circuits
RC1B	DC Circuits
RC1C	DC Circuits
RC2A	DC Circuits
RC3A	DC Circuits
RC3B	DC Circuits
RC4A	DC Circuits
RC4B	DC Circuits
RC5A	DC Circuits
RC6A	DC Circuits
RC7A	DC Circuits
RC7B	DC Circuits
RC8	DC Circuits
RC9	DC Circuits
CHARGE1A	Electric Field
CHARGE1B	Electric Field
CHARGE2	Electric Field
COUL1A	Electric Field
COUL1B	Electric Field
COUL1C	Electric Field
COUL2A	Electric Field
COUL2B	Electric Field
COUL2C	Electric Field
COUL3	Electric Field
EFIELD1A	Electric Field
EFIELD1B	Electric Field
EFIELD1C	Electric Field
EFIELD1D	Electric Field
EFIELD1E	Electric Field
EFIELD2	Electric Field
EFIELD3	Electric Field
EFIELD4A	Electric Field
EFIELD4B	Electric Field
FOR1A	Electric Field
FOR1B	Electric Field
FOR1C	Electric Field
FOR2A	Electric Field
FOR2B	Electric Field
FOR4A	Electric Field
FOR4B	Electric Field
FOR5	Electric Field
FOR7A	Electric Field
FOR7B	Electric Field
FOR8A	Electric Field
FOR8B	Electric Field
FOR9A	Electric Field
FOR9B	Electric Field
FOR10A	Electric Field
FOR10B	Electric Field
FOR11A	Electric Field
FOR11B	Electric Field
FOR11C	Electric Field
ELEC1A	Electric Field
ELEC1B	Electric Field
ELEC2	Electric Field
ELEC3B	Electric Field
ELEC4B	Electric Field
ELEC5B	Electric Field
ELEC6B	Electric Field
GAUSS1	Electric Field
GAUSS3	Electric Field
GAUSS4	Electric Field
GAUSS5	Electric Field
GAUSS6	Electric Field
GAUSS8	Electric Field
GAUSS9	Electric Field
GAUSS10	Electric Field
GAUSS11	Electric Field
DIP1A	Electric Field
DIP1B	Electric Field
EPOT1A	Electric Potential
EPOT1B	Electric Potential
EPOT1C	Electric Potential
EPOT2	Electric Potential
POT1A	Electric Potential
POT1B	Electric Potential
POT2A	Electric Potential
POT2B	Electric Potential
POT2C	Electric Potential
POT3A	Electric Potential
POT3B	Electric Potential
POT4	Electric Potential
POT5	Electric Potential
POT6	Electric Potential
POT7	Electric Potential
POT8	Electric Potential
FARA1A	Electromagnetic Induction
FARA1B	Electromagnetic Induction
FARA2A	Electromagnetic Induction
FARA2B	Electromagnetic Induction
FARA3A	Electromagnetic Induction
FARA3B	Electromagnetic Induction
FARA4A	Electromagnetic Induction
FARA4B	Electromagnetic Induction
FARA5A	Electromagnetic Induction
FARA5B	Electromagnetic Induction
FARA5C	Electromagnetic Induction
FARA6A	Electromagnetic Induction
FARA6B	Electromagnetic Induction
FARA7A	Electromagnetic Induction
FARA7B	Electromagnetic Induction
FARA7C	Electromagnetic Induction
FARA7D	Electromagnetic Induction
FARA8A	Electromagnetic Induction
FARA8B	Electromagnetic Induction
FARA8C	Electromagnetic Induction
FARA9	Electromagnetic Induction
FARA10A	Electromagnetic Induction
FARA10B	Electromagnetic Induction
FARA11A	Electromagnetic Induction
FARA11B	Electromagnetic Induction
AMP1	Electromagnetic Induction
EMWAVE1	Electromagnetic Waves
WAVE19	Electromagnetic Waves
EMWAVE3A	Electromagnetic Waves
EMWAVE4	Electromagnetic Waves
EMWAVE5	Electromagnetic Waves
E1A	Energy-Work
E1B	Energy-Work
E1C	Energy-Work
E2A	Energy-Work
E2B	Energy-Work
E2C	Energy-Work
E3A	Energy-Work
E4A	Energy-Work
E4B	Energy-Work
E4C	Energy-Work
E5A	Energy-Work
E5B	Energy-Work
E6A	Energy-Work
E7A	Energy-Work
E7B	Energy-Work
E8A	Energy-Work
E8B	Energy-Work
E9A	Energy-Work
E9B	Energy-Work
E10A	Energy-Work
E11A	Energy-Work
WE1A	Energy-Work
WE2A	Energy-Work
WE3A	Energy-Work
WE4A	Energy-Work
WE5	Energy-Work
WE6	Energy-Work
WE8	Energy-Work
WE9	Energy-Work
EGRAV1	Energy-Work
FLUIDS1	Fluids
FLUIDS2	Fluids
FLUIDS3	Fluids
FLUIDS4	Fluids
FLUIDS5	Fluids
FLUIDS6	Fluids
FLUIDS7	Fluids
FLUIDS8	Fluids
FLUIDS9	Fluids
FLUIDS11	Fluids
FLUIDS12	Fluids
FLUIDS13	Fluids
FLUIDS14	Fluids
FLUIDS15	Fluids
FBD1A	Free Body Diagrams
FBD1B	Free Body Diagrams
FBD2A	Free Body Diagrams
FBD3A	Free Body Diagrams
FBD4A	Free Body Diagrams
FBD5A	Free Body Diagrams
FBD6A	Free Body Diagrams
FBD8	Free Body Diagrams
FBD9	Free Body Diagrams
IND1A	Inductance
IND1B	Inductance
IND1C	Inductance
IND2A	Inductance
IND3A	Inductance
IND3B	Inductance
IND3C	Inductance
IND4	Inductance
LR1A	Inductance
LR1B	Inductance
LR1C	Inductance
LR1D	Inductance
LR2A	Inductance
LR2B	Inductance
LR3A	Inductance
LR3B	Inductance
LC1A	Inductance
LC2A	Inductance
LC2B	Inductance
LRC1A	Inductance
LRC2A	Inductance
LMOM1A	Linear Momentum
LMOM1B	Linear Momentum
LMOM2A	Linear Momentum
LMOM2B	Linear Momentum
LMOM3A	Linear Momentum
LMOM4A	Linear Momentum
LMOM5	Linear Momentum
LMOM6	Linear Momentum
LMOM7	Linear Momentum
PGRAPH1	Linear Momentum
PGRAPH2	Linear Momentum
PGRAPH3	Linear Momentum
IMP1	Linear Momentum
IMP2	Linear Momentum
IMP3A	Linear Momentum
IMP3B	Linear Momentum
IMP3C	Linear Momentum
CM1	Linear Momentum
CM2	Linear Momentum
CM3	Linear Momentum
ROC1	Linear Momentum
ROC2	Linear Momentum
ROC3	Linear Momentum
ROC4	Linear Momentum
ROC5	Linear Momentum
ROC6	Linear Momentum
MAG1A	Magnetic Field
MAG1B	Magnetic Field
MAG1C	Magnetic Field
MAG2A	Magnetic Field
MAG2B	Magnetic Field
MAG3A	Magnetic Field
MAG3B	Magnetic Field
MAG4A	Magnetic Field
MAG5A	Magnetic Field
MAG5B	Magnetic Field
MAGTOR1A	Magnetic Field
MAGTOR1B	Magnetic Field
MAGTOR1C	Magnetic Field
MAGTOR1D	Magnetic Field
MAGDIP1	Magnetic Field
MAGDIP2	Magnetic Field
MAGDIP3	Magnetic Field
MAGDIP4	Magnetic Field
MAG6A	Magnetic Field
MAG6B	Magnetic Field
MAG6C	Magnetic Field
MAG7	Magnetic Field
MAG8A	Magnetic Field
MAG8B	Magnetic Field
MAG9	Magnetic Field
MAG10	Magnetic Field
MAG11	Magnetic Field
MAG12	Magnetic Field
MIRROR1	Optics
MIRROR2	Optics
MIRROR3	Optics
MIRROR4	Optics
LENS1A	Optics
LENS1B	Optics
LENS2A	Optics
LENS2B	Optics
LENS3A	Optics
LENS3B	Optics
LENS4A	Optics
LENS4B	Optics
LENS5A	Optics
LENS5B	Optics
REF1	Optics
REF2A	Optics
REF2B	Optics
REF2C	Optics
REF3A	Optics
REF3B	Optics
REF4A	Optics
REF4B	Optics
REF5A	Optics
REF5B	Optics
REF6	Optics
INT1A	Optics
INT1B	Optics
INT1C	Optics
INT1D	Optics
INT2A	Optics
INT2B	Optics
OSC1	Oscillations
OSC2	Oscillations
OSC3	Oscillations
OSC4	Oscillations
OSC5	Oscillations
OSC6	Oscillations
OSC7	Oscillations
OSC8	Oscillations
POW1A	Power
POW1B	Power
POW2A	Power
POW3A	Power
POW4A	Power
POW4B	Power
POW5A	Power
POW5B	Power
POW5C	Power
POW5D	Power
POW6A	Power
EQRES1A	Resistance
EQRES1B	Resistance
EQRES1C	Resistance
EQRES1D	Resistance
EQRES1E	Resistance
EQRES2A	Resistance
EQRES2B	Resistance
EQRES3A	Resistance
EQRES3B	Resistance
EQRES4A	Resistance
EQRES4B	Resistance
EQRES5A	Resistance
EQRES6A	Resistance
EQRES7A	Resistance
EQRES7B	Resistance
EQRES8A	Resistance
EQRES8B	Resistance
DR1A	Rotational Dynamics
DR2A	Rotational Dynamics
DR2B	Rotational Dynamics
DR3A	Rotational Dynamics
DR4A	Rotational Dynamics
DR5A	Rotational Dynamics
DR6A	Rotational Dynamics
DR6B	Rotational Dynamics
DR7A	Rotational Dynamics
DR8A	Rotational Dynamics
EROT2	Rotational Dynamics
EROT3	Rotational Dynamics
EROT4	Rotational Dynamics
GRAV1	Rotational Dynamics
GRAV2	Rotational Dynamics
GRAV3	Rotational Dynamics
GRAV4	Rotational Dynamics
GRAV5	Rotational Dynamics
KR8	Rotational Kinematics
KR9	Rotational Kinematics
KR1A	Rotational Kinematics
KR1B	Rotational Kinematics
KR1C	Rotational Kinematics
KR2A	Rotational Kinematics
KR2B	Rotational Kinematics
KR3A	Rotational Kinematics
KR3B	Rotational Kinematics
KR3C	Rotational Kinematics
KR4A	Rotational Kinematics
KR4B	Rotational Kinematics
KR5A	Rotational Kinematics
KR6A	Rotational Kinematics
KR7A	Rotational Kinematics
S1A	Statics
S1B	Statics
S1C	Statics
S1D	Statics
S1E	Statics
S1F	Statics
S2A	Statics
S2B	Statics
S2C	Statics
S2D	Statics
S2E	Statics
S3A	Statics
S3B	Statics
S3C	Statics
S4A	Statics
S4B	Statics
S5A	Statics
S6A	Statics
S7A	Statics
S7B	Statics
S8A	Statics
S9A	Statics
S10A	Statics
S11A	Statics
S11B	Statics
S12A	Statics
S13	Statics
S14	Statics
S15	Statics
S16	Statics
S17	Statics
DQ1	Translational Dynamics
DT1A	Translational Dynamics
DT1B	Translational Dynamics
DT1C	Translational Dynamics
DT2A	Translational Dynamics
DT3A	Translational Dynamics
DT3B	Translational Dynamics
DT3C	Translational Dynamics
DT4A	Translational Dynamics
DT4B	Translational Dynamics
DT5A	Translational Dynamics
DT6A	Translational Dynamics
DT6B	Translational Dynamics
DT6C	Translational Dynamics
DT7A	Translational Dynamics
DT7B	Translational Dynamics
DT8A	Translational Dynamics
DT9A	Translational Dynamics
DT10A	Translational Dynamics
DT11A	Translational Dynamics
DT11B	Translational Dynamics
DT12A	Translational Dynamics
DT13A	Translational Dynamics
DT13B	Translational Dynamics
DT14A	Translational Dynamics
DT14B	Translational Dynamics
DT16	Translational Dynamics
DT17	Translational Dynamics
DT18	Translational Dynamics
DT19	Translational Dynamics
KT1A	Translational Kinematics
KT1B	Translational Kinematics
KT2A	Translational Kinematics
KT2B	Translational Kinematics
KT3A	Translational Kinematics
KT3B	Translational Kinematics
KT4A	Translational Kinematics
KT4B	Translational Kinematics
KT5A	Translational Kinematics
KT6A	Translational Kinematics
KT6B	Translational Kinematics
KT7A	Translational Kinematics
KT7B	Translational Kinematics
KT8A	Translational Kinematics
KT8B	Translational Kinematics
KT9A	Translational Kinematics
KT9B	Translational Kinematics
KT10A	Translational Kinematics
KT10C	Translational Kinematics
KT11A	Translational Kinematics
KT11B	Translational Kinematics
KT12A	Translational Kinematics
KT12B	Translational Kinematics
KT12C	Translational Kinematics
KT13A	Translational Kinematics
KT13B	Translational Kinematics
KT13C	Translational Kinematics
KT14A	Translational Kinematics
KT14B	Translational Kinematics
KGRAPH1	Translational Kinematics
KGRAPH2	Translational Kinematics
KGRAPH3	Translational Kinematics
KGRAPH4	Translational Kinematics
KGRAPH5	Translational Kinematics
KGRAPH6	Translational Kinematics
KGRAPH7	Translational Kinematics
KGRAPH8	Translational Kinematics
KGRAPH9	Translational Kinematics
KGRAPH10	Translational Kinematics
KGRAPH11	Translational Kinematics
KGRAPH12	Translational Kinematics
KGRAPH13	Translational Kinematics
KGRAPH14	Translational Kinematics
KGRAPH16	Translational Kinematics
KGRAPH17	Translational Kinematics
KGRAPH18	Translational Kinematics
KGRAPH19	Translational Kinematics
KGRAPH20	Translational Kinematics
KGRAPH21	Translational Kinematics
VEC1A	Vectors
VEC1B	Vectors
VEC1C	Vectors
VEC1D	Vectors
VEC2A	Vectors
VEC2B	Vectors
VEC2C	Vectors
VEC2D	Vectors
VEC3A	Vectors
VEC3B	Vectors
VEC3C	Vectors
VEC4A	Vectors
VEC4B	Vectors
VEC4C	Vectors
VEC4D	Vectors
VEC5A	Vectors
VEC5B	Vectors
VEC5C	Vectors
VEC5D	Vectors
VEC6A	Vectors
VEC6B	Vectors
VEC6C	Vectors
VEC6D	Vectors
VEC7A	Vectors
VEC8A	Vectors
VEC8B	Vectors
VEC8C	Vectors
VEC9	Vectors
RELVEL1A	Vectors
RELVEL2A	Vectors
RELVEL3A	Vectors
MOT1	Vectors
MOT2	Vectors
MOT3	Vectors
MOT4	Vectors
WAVE1	Waves
WAVE2	Waves
WAVE3	Waves
WAVE4	Waves
WAVE5	Waves
WAVE6	Waves
WAVE8	Waves
WAVE9	Waves
WAVE10	Waves
WAVE11	Waves
WAVE12	Waves
WAVE13	Waves
WAVE14	Waves
WAVE15	Waves
WAVE16	Waves
WAVE17	Waves
WAVE18	Waves
WAVE24	Waves
FOR4A	Electric Field
FOR4B	Electric Field
ELEC1A	Electric Field
FOR4C	Electric Field
ELEC2	Electric Field
ELEC3A	Electric Field
ELEC4A	Electric Field
ELEC5A	Electric Field
ELEC6A	Electric Field
ELEC7A	Electric Field